37 26 26 26 26 26 26 26 26 26 26 26 26 26 26 26 26 26 26 26 26 26 26 26 26 26 26 26 26 26 26 26 26 26 26 26 26 26 26 26 26 26 26 26 26 26 26 26 26 26 26 26 26 26 26 26 26 26 26 26 26 26 26 26 26 26 26 26 26 26 26 30
25 31 31 31 31 31 31 31 31 31 31 31 31 31 31 31 31 31 31 31 31 31 31 31 31 31 31 31 31 31 31 31 31 31 31 31 31 31 31 31 31 31 31 31 31 31 31 31 31 31 31 31 31 31 31 31 31 31 31 31 31 31 31 31 31 31 31 31 31 31 31 25
25 31 37 26 26 26 26 26 26 26 26 26 26 30 31 31 31 31 31 31 37 39 39 39 39 39 39 39 39 39 39 39 39 39 39 39 39 39 39 39 39 39 39 39 39 39 39 39 39 39 30 31 31 31 31 31 31 31 37 26 26 26 26 26 26 26 26 26 26 30 31 25
25 31 25 42 42 42 42 42 42 42 42 42 42 32 31 31 31 31 31 31 25 41 41 41 41 41 41 41 41 42 42 42 42 42 42 42 42 42 42 42 42 42 42 42 41 41 41 41 41 41 25 31 31 31 31 31 31 31 25 42 42 42 42 42 42 42 42 42 42 32 31 25
25 31 25 42 42 42 42 42 42 42 42 42 42 32 31 31 31 31 31 31 25 41 41 41 41 41 37 39 40 40 40 40 40 40 40 40 40 40 40 40 40 40 40 40 30 41 41 41 41 41 25 31 31 31 31 31 31 31 25 42 42 42 42 42 42 42 42 42 42 32 31 25
25 31 25 42 42 42 42 42 42 42 42 42 42 32 31 31 31 31 31 31 25 41 41 41 41 41 25 41 41 42 42 42 42 42 42 42 42 42 42 42 42 42 41 42 25 41 41 41 41 41 32 31 31 31 31 31 31 31 25 42 42 42 42 42 42 42 42 42 42 32 31 25
25 31 25 42 42 42 42 42 42 42 42 42 42 32 31 31 31 31 31 31 25 41 41 41 41 41 25 41 42 37 38 40 40 40 40 40 40 40 40 40 39 30 41 42 25 41 41 41 41 41 32 31 31 31 31 31 31 31 25 42 42 42 42 42 42 42 42 42 42 32 31 25
25 31 25 42 42 42 42 42 42 42 42 42 42 32 31 31 31 31 31 31 25 41 41 41 41 41 25 41 41 25 41 41 41 41 41 41 41 41 41 41 42 25 41 42 25 41 41 41 41 41 32 31 31 31 31 31 31 31 25 42 42 42 42 42 42 42 42 42 42 32 31 25
25 31 25 42 42 42 42 42 42 42 42 42 42 32 31 31 31 31 31 31 25 41 41 41 41 41 25 41 41 25 41 41 41 41 41 41 41 41 41 41 42 25 41 42 25 41 41 41 41 41 32 31 31 31 31 31 31 31 25 42 42 42 42 42 42 42 42 42 42 32 31 25
25 31 25 42 42 42 42 42 42 42 42 42 42 32 31 31 31 31 31 31 25 41 41 41 41 41 25 41 41 25 41 41 41 41 41 35 41 41 41 41 42 25 41 42 25 41 41 41 41 41 32 31 31 31 31 31 31 31 25 42 42 42 42 42 42 42 42 42 42 32 31 25
25 31 28 26 26 26 26 36 36 26 26 26 26 29 31 31 31 31 31 31 25 41 41 41 41 41 25 41 41 25 41 41 41 41 41 41 41 41 41 41 42 25 41 42 25 41 41 41 41 41 32 31 31 31 31 31 31 31 28 26 26 26 26 36 36 26 26 26 26 29 31 25
25 31 31 31 31 31 24 36 36 24 24 31 31 31 31 31 31 31 31 31 25 41 41 41 41 41 25 41 41 25 41 41 41 41 41 41 41 41 41 41 42 25 41 42 25 41 41 41 41 41 32 31 31 31 31 31 31 31 31 31 31 31 31 36 36 31 31 31 31 31 31 25
25 31 31 31 31 31 33 42 42 33 31 31 31 31 31 31 31 31 31 31 25 41 41 41 41 41 25 41 41 25 41 41 41 41 41 41 41 41 41 41 42 25 41 42 25 41 41 41 41 41 32 31 31 31 31 31 31 31 31 31 31 31 33 42 42 33 31 31 31 31 31 25
25 31 31 31 31 31 33 42 42 33 31 31 31 31 31 31 31 31 31 31 25 41 41 41 41 41 25 41 41 28 26 26 26 24 36 36 36 24 26 26 26 29 41 42 25 41 41 41 41 41 32 31 31 31 33 33 33 33 33 33 33 33 33 42 42 33 31 31 31 31 31 25
25 31 31 31 31 31 33 42 42 33 31 31 31 31 31 31 31 31 31 31 25 41 41 41 41 41 25 41 41 41 41 41 41 42 42 42 42 42 42 41 41 41 41 42 25 41 41 41 41 41 32 31 31 31 33 42 42 42 42 42 42 42 42 42 42 33 33 33 33 33 31 25
25 31 31 31 31 31 33 42 42 33 31 31 31 31 31 31 31 31 31 31 25 41 41 41 41 41 25 41 41 41 41 41 41 41 41 41 41 41 41 41 41 41 41 42 25 41 41 41 41 41 32 31 31 31 33 42 42 42 42 42 42 42 42 42 42 33 33 42 42 33 31 25
25 31 31 31 31 31 33 42 42 33 31 31 31 31 31 31 31 31 31 31 25 41 41 41 41 41 25 41 41 41 41 41 41 41 41 41 41 42 41 41 41 41 41 42 25 41 41 41 41 41 32 31 31 31 33 42 42 33 33 33 33 33 33 33 33 33 33 42 42 33 31 25
25 33 33 33 33 31 33 42 42 33 31 31 31 31 31 31 31 31 31 31 25 41 41 41 41 41 28 26 26 26 26 26 24 24 36 36 36 24 24 26 26 26 26 26 29 41 41 41 41 41 32 31 31 31 33 42 42 33 42 42 42 42 42 42 42 42 33 42 42 33 31 25
25 33 42 42 33 31 33 42 42 33 31 31 31 31 31 31 31 31 31 31 25 41 41 41 41 41 42 41 41 41 41 41 41 24 36 36 36 24 41 41 41 41 42 42 42 41 41 41 41 41 32 31 31 31 33 42 42 33 42 42 42 42 42 42 42 42 42 42 42 33 31 25
25 33 42 42 33 31 33 42 42 33 31 31 31 31 31 31 31 31 31 31 25 41 41 41 41 42 42 42 42 42 42 42 42 42 42 42 42 42 42 42 42 42 42 42 42 42 41 41 41 41 32 31 31 31 33 42 42 33 42 42 42 42 42 42 42 42 33 42 42 33 31 25
25 33 42 42 33 31 33 42 42 33 31 31 31 31 31 31 31 31 31 31 25 41 41 41 41 42 42 42 42 42 42 42 42 42 42 42 42 42 42 42 42 42 42 42 42 42 41 41 41 41 32 31 31 31 33 42 42 33 42 42 42 42 42 42 42 42 33 42 42 33 31 25
25 33 42 42 33 31 33 42 42 33 31 31 31 31 31 31 31 31 31 31 25 41 41 41 41 41 41 41 41 41 41 41 41 42 42 42 42 42 42 41 41 41 41 41 41 41 41 41 41 41 32 31 31 31 33 42 42 33 42 42 33 33 33 33 33 33 33 42 42 33 31 25
25 33 42 42 33 31 33 42 42 33 31 31 31 31 31 31 31 31 31 31 28 26 26 26 26 26 26 26 26 26 26 24 24 24 36 36 36 24 24 24 26 26 26 26 26 26 26 26 26 26 29 31 31 31 33 42 42 33 42 42 33 42 42 42 42 42 42 42 42 33 31 25
25 33 42 42 33 31 33 42 42 33 31 31 31 31 31 31 31 31 31 31 31 31 31 31 31 31 31 31 31 31 31 31 24 24 36 36 36 24 24 31 31 31 31 31 31 31 31 31 31 31 31 31 31 31 33 42 42 33 42 42 33 42 42 42 42 42 42 42 42 33 31 25
25 33 42 42 33 31 33 42 42 33 31 31 31 31 31 31 31 31 31 31 31 31 31 31 31 31 31 31 31 31 31 31 31 24 36 36 36 24 31 31 31 31 31 31 31 31 31 31 31 31 31 31 31 31 33 42 42 33 33 42 33 33 33 33 33 33 33 42 42 33 31 25
25 33 42 42 33 31 33 42 42 33 31 31 31 31 31 31 31 31 31 31 31 31 31 31 31 31 31 31 31 31 31 31 31 33 42 42 42 33 31 31 31 31 31 31 31 31 31 31 31 31 31 31 31 31 33 42 42 42 42 42 42 42 42 42 42 42 33 42 42 33 31 25
25 33 42 42 33 31 33 42 42 33 31 31 31 31 31 31 31 31 31 31 31 31 31 31 31 31 31 31 31 31 31 31 31 33 42 42 42 33 31 31 31 31 31 33 33 33 33 33 33 33 33 33 33 33 33 42 42 42 42 42 42 42 42 42 42 42 33 42 42 33 31 25
25 33 42 42 33 33 33 42 42 33 33 33 33 33 33 33 33 33 33 33 33 33 33 33 33 33 33 33 33 33 33 31 31 33 42 42 42 33 31 31 31 31 31 33 42 42 42 42 42 42 42 42 42 42 42 42 42 42 42 42 42 42 42 42 42 42 33 42 42 33 31 25
25 33 42 42 42 42 42 42 42 42 42 42 42 42 42 42 42 42 42 42 42 42 42 42 42 42 42 42 42 42 33 31 31 33 42 42 42 33 33 33 33 33 33 33 42 42 42 42 42 42 42 42 42 42 42 42 42 33 33 33 33 42 42 42 42 42 33 42 42 33 31 25
25 33 42 42 42 42 42 42 42 42 42 42 42 42 42 42 42 42 42 42 42 42 42 42 42 42 42 42 42 42 33 31 31 33 42 42 42 42 42 42 42 42 42 42 42 42 33 33 33 33 33 33 33 33 33 33 33 33 42 42 33 42 42 42 42 42 33 42 42 33 31 25
25 33 42 42 33 33 33 33 33 33 33 33 33 33 33 33 33 33 33 33 33 33 33 33 33 33 33 33 42 42 33 33 33 33 42 42 42 42 42 42 42 42 42 42 42 42 33 31 31 31 31 31 31 31 31 31 31 33 42 42 33 42 42 42 42 42 33 42 42 33 31 25
25 33 42 42 33 31 31 31 31 31 31 31 31 31 31 31 31 31 31 31 31 31 31 31 31 31 31 33 42 42 42 42 42 42 42 42 33 33 33 33 33 33 33 33 33 33 33 31 31 31 31 31 31 31 31 31 31 33 42 42 33 42 42 42 42 42 33 42 42 33 31 25
25 33 42 42 33 31 31 31 31 31 31 31 31 31 31 31 31 31 31 31 31 31 31 31 31 31 31 33 42 42 42 42 42 42 42 42 33 31 31 31 31 31 31 31 31 31 31 31 31 31 31 31 31 31 31 31 31 33 42 42 33 42 42 42 42 42 33 42 42 33 31 25
25 33 42 42 33 31 31 31 31 31 31 31 31 31 31 31 31 31 31 31 31 31 31 31 31 31 31 33 33 33 33 33 33 33 33 33 33 31 31 31 31 31 31 31 31 31 31 31 31 31 31 31 31 31 31 31 31 33 42 42 33 42 42 42 42 42 33 42 42 33 31 25
25 33 42 42 33 31 31 31 31 31 31 31 31 31 31 31 31 31 31 31 31 31 31 31 31 31 31 31 33 42 42 33 31 31 31 31 31 31 31 31 31 31 31 31 31 31 31 31 31 31 31 31 31 31 31 31 31 33 42 42 33 42 42 42 42 42 33 42 42 33 31 25
25 33 42 42 33 31 31 31 31 31 31 31 31 31 31 31 31 31 31 31 31 31 31 31 31 31 31 31 33 42 42 33 31 31 31 31 31 31 31 31 31 31 31 31 31 31 31 31 31 31 31 31 31 31 31 31 31 33 42 42 33 42 42 42 42 42 33 42 42 33 31 25
25 33 42 42 33 31 31 31 31 31 31 31 31 31 31 31 31 31 31 31 31 31 31 31 31 31 31 31 33 42 42 33 31 31 31 31 31 31 31 31 31 31 31 31 31 31 31 31 31 31 31 31 31 31 31 31 31 33 42 42 33 42 42 42 42 42 33 42 42 33 31 25
25 33 42 42 33 31 31 31 31 31 31 31 31 31 31 31 31 31 31 31 31 31 31 31 31 31 31 31 33 42 42 33 31 31 31 31 31 31 31 31 31 31 31 31 31 31 31 31 31 31 31 31 31 31 31 31 31 33 42 42 33 33 33 33 33 33 33 42 42 33 31 25
25 33 42 42 33 31 31 31 31 31 31 31 31 31 31 31 31 31 31 31 31 31 31 31 31 31 31 31 33 42 42 33 31 31 31 31 31 31 31 31 31 31 31 31 31 31 31 31 31 31 31 31 31 31 31 31 31 33 42 42 42 42 42 42 42 42 42 42 42 33 31 25
25 33 42 42 33 33 33 33 33 33 33 33 33 33 33 33 33 33 33 33 33 33 33 33 33 33 33 33 33 42 42 33 33 33 33 33 33 33 33 33 33 33 33 33 33 33 33 33 33 33 33 33 33 33 33 33 33 33 42 42 42 42 42 42 42 42 42 42 42 33 31 25
25 33 42 42 42 42 42 42 42 42 42 42 42 42 42 42 42 42 42 42 42 42 42 42 42 42 42 42 42 42 42 42 42 42 42 42 42 42 42 42 42 42 42 42 42 42 42 42 42 42 42 42 42 42 42 42 42 42 42 42 42 33 33 33 33 33 33 33 33 33 31 25
25 33 42 42 42 42 42 42 42 42 42 42 42 42 42 42 42 42 42 42 42 42 42 42 42 42 42 42 42 42 42 42 42 42 42 42 42 42 42 42 42 42 42 42 42 42 42 42 42 42 42 42 42 42 42 42 42 42 42 42 42 33 31 31 31 31 31 31 31 31 31 25
25 33 42 42 33 33 33 33 33 33 33 33 33 33 33 33 33 33 33 33 33 33 33 33 33 33 42 42 33 33 33 33 33 33 33 33 33 33 33 33 33 33 33 33 33 33 33 33 33 33 33 33 33 33 33 33 33 33 33 42 42 33 31 31 31 31 31 31 31 31 31 25
25 33 42 42 33 31 31 31 31 31 31 31 31 31 31 31 31 31 31 31 31 31 31 31 31 33 42 42 33 24 24 24 24 24 24 24 24 24 24 24 24 24 24 24 24 24 24 24 24 24 24 24 24 24 24 24 24 24 33 42 42 33 31 31 31 31 31 31 31 31 31 25
25 33 42 42 33 31 31 31 31 31 31 31 31 31 31 31 31 31 31 31 31 31 31 31 31 33 42 42 33 24 24 24 24 24 24 24 24 24 24 24 24 24 24 24 24 24 24 24 24 24 24 24 24 24 24 24 24 24 33 42 42 33 42 42 42 42 42 42 42 42 31 25
25 26 26 26 26 26 26 26 26 26 26 26 26 26 26 26 26 26 26 26 26 26 26 26 26 26 26 26 26 26 26 26 26 26 26 26 26 26 26 26 26 26 26 26 26 26 26 26 26 26 26 26 26 26 26 26 26 26 33 36 36 33 26 26 26 26 26 26 26 26 26 25
25 42 42 42 42 42 42 42 42 42 42 42 42 42 42 42 42 42 42 42 42 42 42 42 42 42 42 42 42 42 42 42 42 42 42 42 42 42 42 42 42 42 42 42 42 42 42 42 42 42 42 42 42 42 42 42 42 42 42 42 42 42 42 42 42 42 42 42 42 42 42 25
25 42 42 42 42 42 42 42 42 42 42 42 42 42 42 42 42 42 42 42 42 42 42 42 42 42 42 42 42 42 42 42 42 42 42 42 42 42 42 42 42 42 42 42 42 42 42 42 42 42 42 42 42 42 42 42 42 42 42 42 42 42 42 42 42 42 42 42 42 42 42 25
25 42 42 42 42 42 42 42 42 42 42 42 42 42 42 42 42 42 42 42 42 42 42 42 42 42 42 42 42 42 42 42 42 42 42 42 42 42 42 42 42 42 42 42 42 42 42 42 42 42 42 42 42 42 42 42 42 42 42 42 42 42 42 42 42 42 42 42 42 42 42 25
25 26 26 26 26 26 26 26 26 36 36 36 26 26 26 26 26 26 26 26 26 26 26 26 26 26 26 26 26 26 26 26 26 26 26 26 26 26 26 26 26 26 26 26 26 26 26 26 26 26 26 26 26 26 26 26 26 26 26 26 26 26 26 26 26 24 36 36 36 24 26 25
25 42 31 42 42 42 42 42 42 42 42 42 42 42 42 31 42 31 25 31 31 31 31 31 33 42 42 33 31 31 31 31 31 31 31 31 33 33 33 42 42 42 42 42 42 42 42 42 42 42 42 42 42 42 42 42 42 42 42 42 42 42 42 42 42 24 36 36 36 24 42 25
25 42 31 31 42 42 42 42 42 42 42 42 42 42 31 31 42 42 25 31 31 31 31 31 33 42 42 33 33 33 33 33 33 33 33 33 33 42 42 42 42 42 42 42 42 42 42 42 42 42 42 42 42 42 42 42 42 42 42 42 42 42 42 42 42 42 42 42 42 42 42 25
25 42 42 42 42 42 42 42 42 42 42 42 42 42 42 42 42 42 25 33 33 33 33 33 33 42 42 42 42 42 42 42 42 42 42 42 42 42 42 42 42 33 33 33 33 33 33 33 33 33 33 33 33 33 33 33 33 33 33 33 33 33 33 42 42 42 42 42 42 42 42 25
25 42 42 42 42 42 42 42 42 42 42 42 42 42 42 42 42 42 25 42 42 42 42 42 42 42 42 42 42 42 42 42 42 42 42 42 42 42 42 33 33 31 31 31 31 31 31 31 31 31 31 31 31 31 31 31 31 31 31 31 31 31 31 33 42 42 42 42 42 42 42 25
25 42 42 42 42 42 42 42 42 42 42 31 42 42 42 42 42 42 25 42 42 42 42 42 42 42 42 42 33 33 33 33 33 33 33 33 33 33 33 33 33 33 33 33 33 33 33 31 31 31 31 31 31 31 31 31 31 31 31 31 31 31 31 33 33 33 33 33 33 33 33 25
25 42 42 42 42 42 42 42 42 42 42 42 42 42 42 42 31 42 25 42 42 42 33 42 42 33 42 42 33 42 42 42 42 42 42 42 42 42 42 42 42 42 42 42 42 42 33 31 31 31 31 33 33 33 33 31 31 31 31 31 31 31 31 31 31 31 31 33 42 42 42 25
25 42 42 42 42 31 42 42 42 42 42 42 42 42 31 42 42 42 25 42 42 42 33 42 42 33 42 42 33 42 42 42 42 42 42 42 42 42 42 42 42 42 42 42 42 42 33 31 31 31 31 33 42 42 33 31 31 33 33 33 33 33 33 33 33 33 33 33 42 42 42 25
25 42 42 31 42 42 42 42 42 42 42 42 42 42 42 42 42 42 25 42 42 42 33 42 42 33 42 42 33 42 42 33 33 33 33 33 42 42 33 33 33 33 33 33 42 42 33 31 31 31 31 33 42 42 33 31 31 33 42 42 42 42 42 42 42 42 42 42 42 42 33 25
25 42 31 42 42 42 42 42 42 42 42 31 42 42 42 42 42 42 25 42 42 42 33 42 42 33 42 42 33 42 42 33 31 31 31 33 42 42 33 24 24 24 24 33 42 42 33 31 31 31 31 33 42 42 33 31 31 33 42 42 42 42 42 42 42 42 42 42 42 42 33 25
25 42 42 42 42 42 42 42 42 42 42 42 42 42 31 42 42 42 25 33 33 33 33 42 42 33 42 42 33 42 42 33 31 33 33 33 42 42 33 24 24 24 24 33 42 42 33 31 31 31 31 33 42 42 33 31 31 33 42 42 33 33 33 33 42 42 33 42 42 42 33 25
25 26 26 26 26 26 26 26 26 26 42 42 42 42 42 42 42 42 25 42 42 42 42 42 42 33 42 42 33 42 42 33 31 31 42 42 42 42 33 24 24 24 24 33 42 42 33 33 33 33 33 33 42 42 33 31 31 33 42 42 33 24 24 33 42 42 33 33 33 33 33 25
25 1 1 1 1 1 1 1 1 25 42 31 42 42 42 42 42 42 25 42 42 42 42 42 42 33 33 33 33 42 42 33 31 31 42 42 42 42 33 24 24 24 24 33 42 42 42 42 42 42 42 42 42 42 33 31 31 33 42 42 33 24 24 33 42 42 42 42 42 42 42 25
25 1 1 1 1 1 1 1 1 25 42 42 42 42 42 42 42 42 25 33 33 33 33 42 42 33 42 42 42 42 42 33 31 33 42 42 33 24 24 24 24 24 24 33 42 42 42 42 42 42 42 42 42 42 33 31 31 33 42 42 33 24 24 33 42 42 42 42 42 42 42 25
25 1 1 1 1 1 1 1 1 25 42 42 42 42 42 42 42 42 25 31 31 31 33 42 42 33 42 42 42 42 42 33 31 33 42 42 33 24 24 24 24 24 24 33 33 33 33 33 33 33 33 33 33 33 33 24 24 33 42 42 33 24 24 33 33 33 33 33 33 33 33 25
25 1 1 1 1 1 1 1 1 25 42 42 42 42 31 42 42 42 25 31 31 31 33 42 42 33 33 33 33 33 33 33 31 33 42 42 33 24 24 24 24 24 24 24 24 24 24 24 24 24 24 24 24 24 24 24 24 33 42 42 33 24 24 24 24 24 24 24 24 24 24 25
25 1 1 1 1 1 1 1 1 25 42 42 42 42 42 42 42 42 25 31 31 31 33 42 42 33 24 24 33 31 31 31 31 33 42 42 33 33 33 33 33 33 33 33 33 33 33 33 33 33 33 33 33 33 33 33 33 33 42 42 33 33 33 33 33 33 33 33 24 24 24 25
25 1 1 1 1 1 1 1 1 25 42 42 42 42 42 42 42 42 25 33 33 33 33 42 42 33 33 33 33 33 33 33 33 33 42 42 42 42 42 42 42 42 42 42 42 42 42 42 42 42 42 42 42 42 42 42 42 42 42 42 42 42 42 42 42 42 42 33 24 24 24 25
25 1 1 1 1 1 1 1 1 25 42 42 42 42 42 42 42 42 25 33 42 42 42 42 42 42 42 42 42 42 42 42 42 42 42 42 42 42 42 42 42 42 42 42 42 42 42 42 42 42 42 42 42 42 42 42 42 42 42 42 42 42 42 42 42 42 42 33 24 24 24 25
25 1 1 1 1 1 1 1 1 25 42 42 42 42 42 42 31 42 25 33 42 42 42 42 42 42 42 42 42 42 42 42 42 42 42 42 33 33 33 33 33 33 33 33 33 33 33 33 33 33 33 42 42 33 33 33 33 33 33 33 33 33 33 33 33 42 42 33 33 33 33 25
25 1 1 1 1 1 1 1 1 25 42 42 31 42 42 42 42 42 25 33 42 42 33 33 33 33 33 33 33 33 33 33 33 33 42 42 33 31 31 31 31 31 31 31 31 31 31 31 31 31 33 42 42 33 31 31 31 31 31 31 31 31 31 31 33 42 42 42 42 42 42 25
25 1 1 1 1 1 1 1 1 25 42 42 42 42 42 42 42 42 25 33 42 42 33 31 31 31 31 31 31 31 31 31 31 33 42 42 33 31 31 31 31 31 31 31 31 31 31 31 31 31 33 42 42 33 31 31 31 31 31 31 31 31 31 31 33 42 42 42 42 42 42 25
28 27 27 27 27 27 27 27 27 27 27 27 27 27 27 27 27 27 27 27 27 27 27 27 27 27 27 27 27 27 27 27 27 27 27 27 27 27 27 27 27 27 27 27 27 27 27 27 27 27 27 27 27 27 27 27 27 27 27 27 27 27 27 27 27 27 27 27 27 27 27 29
