2 0 0 0 1 0 2 1 0 0 1 0 2 1 0 2 2 0 1 
2 1 2 1 0 1 1 0 1 0 0 1 1 1 2 2 1 0 1 
0 2 2 1 0 1 0 1 0 1 0 1 14 13 13 17 1 2 2 
1 0 1 12 12 12 12 12 12 12 0 0 14 13 13 17 1 1  
1 1 0 12 14 5 5 5 6 12 1 1 14 13 13 17 1 1 1
12 12 12 12 11 3 3 3 7 12 1 0 14 13 13 17 0 0 1
5 5 5 5 3 3 3 3 7 12 2 2 14 13 13 17 0 0 2
3 3 3 3 3 3 3 3 7 15 15 15 15 13 13 17 0 0 2
3 3 3 3 3 3 3 3 7 13 13 13 13 13 17 0 1 1 
3 3 3 3 3 3 3 3 7 13 13 13 13 13 17 1 0 0
3 3 3 3 3 3 3 3 7 16 16 16 16 13 13 17 1 1 0
9 9 9 9 9 3 3 3 7 12 2 2 14 13 13 17 15 17 0
12 12 12 12 12 11 3 9 8 12 1 1 14 13 13 13 13 17 2
2 0 1 0 12 11 7 12 12 12 0 0 14 13 13 13 13 17 1
2 0 2 1 12 10 8 12 1 1 0 0 16 16 16 13 13 17 0
2 2 0 1 12 12 12 12 1 0 1 0 2 2 0 14 13 13 17 2
2 2 1 0 1 0 1 0 2 0 1 0 2 1 14 13 13 17 1
2 1 2 1 2 1 1 2 0 1 0 1 1 0 1 0 1 0 1 
1 0 1 0 1 0 2 0 2 1 0 0 1 0 2 1 0 1 0 