1 1 1 1 1 1 1 1 1 1 1 1 1 1 1 1 1 1 1 1 1 1 1 1 1 1 1 1 1 1 1 1 1 1 1 1 1 1 1 1 1 1 1 1 1 1 1 1 1 1 1 1 1 1 1 1 1 1 1 1 1 1 1 1 1 1 1 1 1 1 1 1 
1 1 1 1 1 1 1 1 1 1 1 1 1 1 1 1 1 1 1 1 1 1 1 1 1 1 1 1 1 1 1 1 1 1 1 1 1 1 1 1 1 1 1 1 1 1 1 1 1 1 1 1 1 1 1 1 1 1 1 1 1 1 1 1 1 1 1 1 1 1 1 1 
1 1 1 1 1 1 1 1 1 1 1 1 1 1 1 1 1 1 1 1 1 1 1 1 1 1 1 1 1 1 1 1 1 1 1 1 1 1 1 1 1 1 1 1 1 1 1 1 1 1 1 1 1 1 1 1 1 1 1 1 1 1 1 1 1 1 1 1 1 1 1 1 
1 1 1 1 1 1 1 1 1 1 1 1 1 1 1 1 1 1 1 1 1 1 1 1 1 1 1 1 1 1 1 1 1 1 1 1 1 1 1 1 1 1 1 1 1 1 1 1 1 1 1 1 1 1 1 1 1 1 1 1 1 1 1 1 1 1 1 1 1 1 1 1
1 1 1 1 1 1 1 1 1 1 1 1 1 1 1 1 1 1 1 1 1 1 1 1 1 1 1 1 1 1 1 1 1 1 1 1 1 1 1 1 1 1 1 1 1 1 1 1 1 1 1 1 1 1 1 1 1 1 1 1 1 1 1 1 1 1 1 1 1 1 1 1
1 1 1 1 1 1 9 6 6 6 6 6 6 6 6 6 6 6 6 6 6 6 6 6 6 6 6 6 6 6 6 6 6 6 6 6 6 6 6 6 6 6 6 6 6 6 6 6 6 6 6 6 6 6 6 6 6 6 6 6 6 6 6 6 6 7 1 1 1 1 1 1
1 1 1 1 1 1 4 2 2 2 2 2 2 2 2 2 2 2 2 2 2 2 2 2 2 2 2 2 2 2 2 2 2 2 2 2 2 2 2 2 2 2 2 2 2 2 2 2 2 2 2 2 2 2 2 2 2 2 2 2 2 2 2 2 2 10 1 1 1 1 1 1                                                                                                                                                                                                                                            
1 1 1 1 1 1 4 2 3 3 3 3 3 3 3 3 3 3 3 3 3 3 3 3 3 3 3 3 3 3 3 3 3 3 3 3 3 3 3 3 3 3 3 3 3 3 3 3 3 3 3 3 3 3 3 3 3 3 3 3 3 3 3 3 2 10 1 1 1 1 1 1
1 1 1 1 1 1 4 2 3 0 0 0 0 0 0 0 0 0 0 0 3 3 3 3 3 3 3 3 3 3 3 3 3 3 3 3 3 3 3 3 3 3 3 3 3 3 3 3 3 3 3 3 3 3 3 3 3 3 3 3 3 3 3 3 2 10 1 1 1 1 1 1 
1 1 1 1 1 1 4 2 3 0 3 3 3 3 3 3 3 3 3 0 3 3 3 3 0 0 0 0 3 3 3 3 3 3 3 3 3 3 3 3 3 3 3 0 0 0 0 0 0 0 0 0 0 0 0 0 0 0 0 0 0 0 0 3 2 10 1 1 1 1 1 1
1 1 1 1 1 1 4 2 3 0 3 3 3 3 3 3 3 3 3 0 3 3 3 3 0 3 3 0 3 3 3 3 3 3 12 13 13 14 3 3 3 3 3 0 3 3 3 3 3 3 3 3 3 3 3 3 3 3 3 3 3 0 0 3 2 10 1 1 1 1 1 1
1 1 1 1 1 1 4 2 3 0 3 3 3 3 3 3 3 3 3 0 3 3 3 3 0 3 3 0 3 3 3 3 3 3 15 16 16 17 3 3 3 3 3 0 3 3 3 3 3 3 3 3 3 0 3 3 3 3 3 3 3 0 0 3 2 10 1 1 1 1 1 1 
1 1 1 1 1 1 4 2 3 0 3 3 3 3 3 3 3 3 3 0 3 3 3 3 0 3 3 0 3 3 3 3 3 3 18 19 19 20 3 0 0 0 0 0 3 3 3 3 3 3 3 3 3 0 3 3 3 3 3 3 3 0 0 3 2 10 1 1 1 1 1 1  
1 1 1 1 1 1 4 2 3 0 3 3 0 0 0 0 0 0 0 0 3 3 3 3 0 3 3 0 3 3 3 3 3 3 21 22 22 23 3 0 3 3 3 3 3 3 3 3 3 3 3 3 3 0 3 3 3 3 3 3 3 0 0 3 2 10 1 1 1 1 1 1 
1 1 1 1 1 1 4 2 3 0 3 3 0 3 3 3 3 3 3 0 3 3 3 3 0 3 3 0 3 3 0 0 0 0 0 0 0 3 3 0 3 3 3 3 3 3 3 3 3 3 3 3 3 0 3 3 3 3 3 3 3 0 0 3 2 10 1 1 1 1 1 1
1 1 1 1 1 1 4 2 3 0 3 3 0 3 3 3 3 3 3 0 3 3 3 3 0 3 3 0 3 3 0 3 3 3 3 3 3 3 3 0 3 3 3 3 3 3 3 3 3 3 3 3 3 0 3 3 3 3 3 3 3 0 0 3 2 10 1 1 1 1 1 1
1 1 1 1 1 1 4 2 3 0 3 3 0 3 3 3 3 3 3 0 3 3 3 3 0 3 3 0 0 0 0 3 3 3 3 3 3 3 3 0 0 0 0 0 0 3 3 3 3 3 3 3 3 0 3 0 0 0 0 0 0 0 0 3 2 10 1 1 1 1 1 1 
1 1 1 1 1 1 4 2 3 0 3 3 0 3 3 3 3 3 3 0 3 3 3 3 0 3 3 3 3 3 3 3 3 3 3 0 0 3 3 3 3 3 3 3 3 3 3 3 3 3 3 3 3 0 3 3 3 3 3 3 3 0 0 3 2 10 1 1 1 1 1 1
1 1 1 1 1 1 4 2 3 0 0 0 0 0 0 0 0 3 3 0 0 0 0 0 0 3 3 3 3 3 3 3 3 3 3 0 0 3 3 3 3 3 3 3 0 3 3 3 3 3 3 3 3 0 3 3 3 3 3 3 3 0 0 3 2 10 1 1 1 1 1 1
1 1 1 1 1 1 4 2 3 3 3 3 0 0 0 0 0 3 3 3 3 3 3 3 3 3 3 3 3 3 3 3 3 3 3 0 0 3 3 3 3 3 3 3 0 3 3 3 3 3 3 3 3 0 3 3 3 3 3 3 3 0 0 3 2 10 1 1 1 1 1 1
1 1 1 1 1 1 4 2 3 3 3 3 3 3 3 0 0 3 3 3 3 3 3 3 0 0 0 0 3 3 3 3 3 3 3 0 0 3 3 3 3 3 3 3 0 3 3 3 3 3 3 3 3 0 3 3 3 3 3 3 3 0 0 3 2 10 1 1 1 1 1 1
1 1 1 1 1 1 4 2 3 3 3 3 3 3 3 0 0 0 0 0 0 0 0 0 0 0 0 0 3 3 3 3 3 3 3 0 0 3 3 3 3 3 3 3 0 3 3 3 3 3 3 3 3 0 3 3 3 3 3 3 3 0 0 3 2 10 1 1 1 1 1 1
1 1 1 1 1 1 4 2 3 3 3 3 3 3 3 0 0 0 0 0 0 0 0 0 0 3 0 0 3 3 3 3 3 3 3 0 0 3 3 3 3 3 3 3 0 3 3 3 3 3 3 3 3 0 3 3 3 3 3 3 3 0 0 3 2 10 1 1 1 1 1 1
1 1 1 1 1 1 4 2 3 3 3 3 3 3 3 0 3 3 3 3 3 3 3 3 3 3 0 0 3 3 3 3 3 3 3 0 0 3 3 3 3 3 3 3 0 3 3 3 3 3 3 3 3 0 3 3 3 3 3 3 3 0 0 3 2 10 1 1 1 1 1 1
1 1 1 1 1 1 4 2 3 3 3 3 3 3 3 0 3 3 3 3 3 3 3 3 3 3 0 0 0 0 0 0 0 0 0 0 0 3 3 3 3 3 3 3 0 3 3 3 3 3 3 3 3 0 3 3 3 3 3 3 3 0 0 3 2 10 1 1 1 1 1 1
1 1 1 1 1 1 4 2 3 3 3 3 3 3 3 0 3 3 3 3 3 3 3 3 3 3 0 0 0 0 0 0 0 0 0 0 0 3 3 3 3 3 3 3 0 3 3 3 3 3 3 3 3 0 3 3 3 3 3 3 3 0 0 3 2 10 1 1 1 1 1 1
1 1 1 1 1 1 4 2 3 0 3 0 0 0 0 0 3 3 3 3 3 3 3 3 3 3 3 3 3 3 3 3 3 3 3 0 0 3 3 3 3 3 3 3 0 3 3 3 3 3 3 3 3 0 3 3 3 3 3 3 3 0 0 3 2 10 1 1 1 1 1 1
1 1 1 1 1 1 4 2 3 0 3 3 3 3 0 3 3 3 3 3 3 3 3 3 3 3 3 3 3 3 3 3 3 3 3 0 0 0 0 0 0 0 0 0 0 0 0 0 0 0 0 0 0 0 0 0 0 0 0 0 0 0 0 3 2 10 1 1 1 1 1 1
1 1 1 1 1 1 4 2 3 0 3 3 3 3 0 3 3 3 3 3 3 3 3 3 3 3 3 3 3 3 3 3 3 3 3 0 0 0 0 0 0 0 0 0 0 0 0 0 0 0 0 0 0 0 0 0 0 0 0 0 0 0 0 3 2 10 1 1 1 1 1 1
1 1 1 1 1 1 4 2 3 0 3 3 3 3 0 3 3 3 3 3 3 3 3 3 3 3 3 3 3 3 3 3 3 3 3 0 0 3 3 3 3 3 3 3 3 3 3 3 3 3 3 3 3 3 3 3 3 3 3 3 3 3 3 3 2 10 1 1 1 1 1 1
1 1 1 1 1 1 4 2 3 0 3 3 3 3 3 3 3 3 3 3 3 3 3 3 3 3 3 3 3 3 3 3 3 3 3 0 0 3 3 3 3 3 3 3 3 3 3 3 3 3 3 3 3 3 3 3 3 3 3 3 3 3 3 3 2 10 1 1 1 1 1 1
1 1 1 1 1 1 4 2 3 0 3 3 3 3 0 3 3 3 3 3 3 3 3 3 3 3 3 3 3 3 3 3 3 3 3 0 0 3 3 3 3 3 3 3 3 3 3 3 3 3 3 3 3 3 3 3 3 3 3 3 3 3 3 3 2 10 1 1 1 1 1 1
1 1 1 1 1 1 4 2 3 0 3 3 3 3 0 3 3 3 3 3 3 3 3 3 3 3 3 3 3 3 3 3 3 3 3 0 0 3 3 3 3 3 3 3 3 3 3 3 3 3 3 3 3 3 3 3 3 3 3 3 3 3 3 3 2 10 1 1 1 1 1 1
1 1 1 1 1 1 4 2 3 0 3 3 3 3 0 3 3 3 3 3 3 3 3 3 3 3 3 3 3 3 3 3 3 3 3 0 0 3 3 3 3 3 3 3 3 3 3 3 3 3 3 3 3 3 3 3 3 3 3 3 3 3 3 3 2 10 1 1 1 1 1 1
1 1 1 1 1 1 4 2 3 0 3 3 3 3 0 3 3 3 3 3 3 3 3 3 3 3 3 3 3 3 3 3 3 3 3 0 0 3 3 3 3 3 3 0 0 0 0 0 0 0 0 0 0 0 0 0 0 0 0 3 3 3 3 3 2 10 1 1 1 1 1 1
1 1 1 1 1 1 4 2 3 0 3 3 3 3 0 3 3 3 3 3 3 3 3 3 3 3 3 3 3 3 3 3 3 3 3 0 0 3 3 3 3 3 3 0 3 3 3 3 3 3 3 3 3 3 3 3 3 3 0 3 3 3 3 3 2 10 1 1 1 1 1 1
1 1 1 1 1 1 4 2 3 0 3 3 3 3 0 3 3 3 3 3 3 3 3 3 3 3 3 3 3 3 3 3 3 3 3 0 0 3 3 3 3 3 3 0 3 3 3 3 3 3 3 3 3 3 3 3 3 3 0 0 0 3 3 3 2 10 1 1 1 1 1 1
1 1 1 1 1 1 4 2 3 0 3 3 3 3 0 3 3 3 3 3 3 3 3 3 3 3 0 0 0 0 0 0 0 0 0 0 0 3 3 3 3 3 3 0 3 3 3 3 3 3 3 3 3 3 3 3 3 3 3 3 0 3 3 3 2 10 1 1 1 1 1 1
1 1 1 1 1 1 4 2 3 0 3 3 3 3 0 3 3 3 3 3 3 3 3 3 3 3 0 0 0 0 0 0 0 0 0 0 0 3 3 3 3 3 3 0 3 3 3 3 3 3 3 3 3 3 3 3 3 3 3 3 0 3 3 3 2 10 1 1 1 1 1 1
1 1 1 1 1 1 4 2 3 0 3 3 3 3 0 3 3 3 3 3 3 3 3 3 3 3 0 0 0 3 3 3 3 3 3 0 0 3 3 3 3 3 3 0 3 3 3 3 3 3 3 3 3 3 3 3 3 3 3 3 0 3 3 3 2 10 1 1 1 1 1 1
1 1 1 1 1 1 4 2 3 0 3 3 3 3 0 3 3 3 3 3 3 0 0 0 0 0 0 0 0 3 3 3 3 3 3 0 0 3 3 3 3 3 3 0 3 3 3 3 3 3 3 3 3 3 3 3 3 3 3 3 0 3 3 3 2 10 1 1 1 1 1 1
1 1 1 1 1 1 4 2 3 0 3 3 3 3 0 3 3 3 3 3 3 0 0 0 0 0 0 0 0 3 3 3 3 3 3 0 0 3 3 3 3 3 3 0 3 3 3 3 3 3 3 3 3 3 3 3 3 3 3 3 0 3 3 3 2 10 1 1 1 1 1 1
1 1 1 1 1 1 4 2 3 0 0 0 0 0 0 0 0 0 0 0 0 0 0 3 3 3 3 0 0 3 3 3 3 3 3 0 0 3 3 3 3 3 3 0 3 3 3 3 3 3 3 3 3 3 3 3 3 3 3 3 0 3 3 3 2 10 1 1 1 1 1 1
1 1 1 1 1 1 4 2 3 3 3 3 3 3 0 0 0 0 0 0 0 0 0 3 3 3 3 0 0 3 3 3 3 3 3 0 0 3 3 3 3 3 3 0 3 3 0 0 0 0 0 0 0 0 3 3 3 3 3 3 0 3 3 3 2 10 1 1 1 1 1 1
1 1 1 1 1 1 4 2 3 3 3 3 3 3 0 3 3 3 3 3 3 0 0 3 3 3 3 0 0 3 3 3 3 3 3 0 0 3 3 3 3 3 3 0 3 3 0 0 0 0 0 0 0 0 3 3 3 3 3 3 0 3 3 3 2 10 1 1 1 1 1 1
1 1 1 1 1 1 4 2 3 3 3 3 3 3 0 3 3 3 3 3 3 0 0 3 3 3 3 0 0 3 3 3 3 3 3 0 0 3 3 3 3 3 3 0 0 0 0 0 3 3 3 3 0 0 3 3 3 3 3 3 0 3 3 3 2 10 1 1 1 1 1 1
1 1 1 1 1 1 4 2 3 3 3 3 3 3 0 3 3 3 3 3 3 0 0 3 3 3 3 0 0 3 3 3 3 3 3 0 0 3 3 3 3 3 3 0 0 0 0 0 3 3 3 3 0 0 3 3 3 3 3 3 0 3 3 3 2 10 1 1 1 1 1 1
1 1 1 1 1 1 4 2 3 3 3 3 3 3 0 3 3 3 3 3 3 0 0 3 3 3 3 0 0 3 3 3 3 3 3 0 0 3 3 3 3 3 3 3 3 3 3 3 3 3 3 3 0 0 0 0 0 0 0 0 0 0 3 3 2 10 1 1 1 1 1 1
1 1 1 1 1 1 4 2 3 3 3 3 3 3 0 3 3 3 3 3 3 0 0 0 3 3 3 0 0 3 3 3 3 3 3 0 0 3 3 3 3 3 3 3 3 3 3 3 3 3 3 3 0 0 0 0 0 0 0 0 0 0 3 3 2 10 1 1 1 1 1 1
1 1 1 1 1 1 4 2 3 3 3 3 3 3 0 0 0 0 0 0 0 0 0 0 3 3 3 0 0 3 3 3 3 3 3 0 0 0 0 0 0 0 0 0 3 3 3 3 3 3 3 3 0 0 3 3 3 3 3 3 0 0 3 3 2 10 1 1 1 1 1 1
1 1 1 1 1 1 4 2 3 3 3 3 3 3 0 0 0 0 0 0 0 0 0 0 3 3 3 0 0 3 3 3 3 3 3 0 0 0 0 0 0 0 0 0 3 3 3 3 3 3 3 3 0 0 3 3 3 3 3 3 0 0 3 3 2 10 1 1 1 1 1 1
1 1 1 1 1 1 4 2 3 3 3 3 3 3 0 0 3 3 3 3 3 3 0 0 3 3 3 0 0 0 0 0 0 0 0 0 0 3 3 3 3 3 0 0 0 0 0 3 3 3 3 3 0 0 3 3 3 3 3 3 0 0 3 3 2 10 1 1 1 1 1 1
1 1 1 1 1 1 4 2 3 3 3 3 3 3 0 0 3 3 3 3 3 3 0 0 3 3 3 0 0 0 0 0 0 0 0 0 0 3 3 3 3 3 0 0 0 0 0 3 3 3 3 3 0 0 3 3 3 3 3 3 0 0 3 3 2 10 1 1 1 1 1 1
1 1 1 1 1 1 4 2 3 3 3 3 3 3 0 0 3 3 3 3 3 3 0 0 3 3 3 0 3 3 3 3 3 3 3 0 0 3 3 3 3 3 3 3 3 0 0 3 3 3 3 3 0 0 3 3 3 3 3 3 0 0 3 3 2 10 1 1 1 1 1 1
1 1 1 1 1 1 4 2 3 3 3 3 3 3 0 0 3 3 3 3 3 3 0 0 0 0 0 0 3 3 3 3 3 3 3 0 0 3 3 3 3 3 3 3 3 0 0 0 0 0 0 0 0 0 3 3 3 3 3 3 3 3 3 3 2 10 1 1 1 1 1 1
1 1 1 1 1 1 4 2 3 3 3 3 3 3 0 0 3 3 3 3 3 3 0 0 0 0 0 3 3 3 3 3 3 3 3 0 0 3 3 3 3 3 3 3 3 0 0 0 0 0 0 0 0 0 3 3 3 3 3 3 3 3 3 3 2 10 1 1 1 1 1 1
1 1 1 1 1 1 4 2 3 3 3 3 3 3 0 0 3 3 3 3 3 3 3 3 3 0 0 3 3 3 3 3 3 3 3 0 0 3 3 3 3 3 3 3 3 3 3 3 3 3 3 3 3 3 3 3 3 3 3 3 3 3 3 3 2 10 1 1 1 1 1 1
1 1 1 1 1 1 4 2 3 3 3 3 3 3 0 0 3 3 3 3 3 3 3 3 3 0 0 3 3 3 3 3 3 3 3 0 0 3 3 3 3 3 3 3 3 3 3 3 3 3 3 3 3 3 3 3 3 3 3 3 3 3 3 3 2 10 1 1 1 1 1 1
1 1 1 1 1 1 4 2 3 3 3 0 0 0 0 0 3 3 3 3 3 3 3 3 3 0 0 3 3 3 3 3 3 3 3 0 0 3 3 3 3 3 3 3 3 3 3 3 3 3 3 3 3 3 3 3 3 3 3 3 3 3 3 3 2 10 1 1 1 1 1 1
1 1 1 1 1 1 4 2 3 3 3 0 0 0 0 0 3 3 3 3 3 3 3 3 3 0 0 3 3 3 3 3 3 3 3 0 0 3 3 3 3 3 3 3 3 3 3 3 3 3 3 3 3 3 3 3 3 3 3 3 3 3 3 3 2 10 1 1 1 1 1 1
1 1 1 1 1 1 4 2 3 3 3 0 0 3 3 3 3 3 3 3 3 3 3 3 3 0 0 3 3 3 3 3 3 3 3 0 0 3 3 3 3 3 3 3 3 3 3 3 3 3 3 3 3 3 3 3 3 3 3 3 3 3 3 3 2 10 1 1 1 1 1 1
1 1 1 1 1 1 4 2 3 3 3 0 0 3 3 3 3 3 3 0 3 0 3 3 3 0 0 0 0 0 0 0 0 0 0 0 0 3 3 3 3 3 3 3 3 3 3 3 3 3 3 3 3 3 3 3 3 3 3 3 3 3 3 3 2 10 1 1 1 1 1 1
1 1 1 1 1 1 4 2 3 0 0 0 0 0 0 0 0 0 0 0 3 0 0 0 0 0 0 0 0 0 0 0 0 0 0 0 0 0 0 0 0 0 0 0 0 0 0 0 0 0 0 0 0 0 0 0 0 0 0 0 0 0 0 0 2 10 1 1 1 1 1 1
1 1 1 1 1 1 4 2 3 3 3 3 3 3 3 3 3 3 3 3 3 3 3 3 3 3 3 3 3 3 3 3 3 3 3 0 0 0 0 0 0 0 0 0 0 0 0 0 0 0 0 0 0 0 0 0 0 0 0 0 0 0 0 0 2 10 1 1 1 1 1 1
1 1 1 1 1 1 4 2 3 3 3 3 3 3 3 3 3 3 3 3 3 3 3 3 3 3 3 3 3 3 3 3 3 3 3 3 3 3 3 3 3 3 3 3 3 3 3 3 3 3 3 3 3 3 3 3 3 3 0 0 0 0 0 0 2 10 1 1 1 1 1 1
1 1 1 1 1 1 4 2 2 2 2 2 2 2 2 2 2 2 2 2 2 2 2 2 2 2 2 2 2 2 2 2 2 2 2 2 2 2 2 2 2 2 2 2 2 2 2 2 2 2 2 2 2 2 2 2 2 2 2 2 2 2 2 2 2 10 1 1 1 1 1 1
1 1 1 1 1 1 11 5 5 5 5 5 5 5 5 5 5 5 5 5 5 5 5 5 5 5 5 5 5 5 5 5 5 5 5 5 5 5 5 5 5 5 5 5 5 5 5 5 5 5 5 5 5 5 5 5 5 5 5 5 5 5 5 5 5 8 1 1 1 1 1 1                                                                                                                        
1 1 1 1 1 1 1 1 1 1 1 1 1 1 1 1 1 1 1 1 1 1 1 1 1 1 1 1 1 1 1 1 1 1 1 1 1 1 1 1 1 1 1 1 1 1 1 1 1 1 1 1 1 1 1 1 1 1 1 1 1 1 1 1 1 1 1 1 1 1 1 1 1
1 1 1 1 1 1 1 1 1 1 1 1 1 1 1 1 1 1 1 1 1 1 1 1 1 1 1 1 1 1 1 1 1 1 1 1 1 1 1 1 1 1 1 1 1 1 1 1 1 1 1 1 1 1 1 1 1 1 1 1 1 1 1 1 1 1 1 1 1 1 1 1 1
1 1 1 1 1 1 1 1 1 1 1 1 1 1 1 1 1 1 1 1 1 1 1 1 1 1 1 1 1 1 1 1 1 1 1 1 1 1 1 1 1 1 1 1 1 1 1 1 1 1 1 1 1 1 1 1 1 1 1 1 1 1 1 1 1 1 1 1 1 1 1 1 1
1 1 1 1 1 1 1 1 1 1 1 1 1 1 1 1 1 1 1 1 1 1 1 1 1 1 1 1 1 1 1 1 1 1 1 1 1 1 1 1 1 1 1 1 1 1 1 1 1 1 1 1 1 1 1 1 1 1 1 1 1 1 1 1 1 1 1 1 1 1 1 1 1
1 1 1 1 1 1 1 1 1 1 1 1 1 1 1 1 1 1 1 1 1 1 1 1 1 1 1 1 1 1 1 1 1 1 1 1 1 1 1 1 1 1 1 1 1 1 1 1 1 1 1 1 1 1 1 1 1 1 1 1 1 1 1 1 1 1 1 1 1 1 1 1 1
