73 73 73 73 73 73 73 73 73 73 73 73 73 73 73 73 73 73 73 73 73 73 73 73 73 73 73 73 73 73 73 73 73 73 73 73 73 73 73 73 73 73 73 73 73 73 73 73 73 73 73 73 73 73 73 73 73 73 73 73 73 73 73 73 73 73 73 73 73 73 73 73
73 73 73 73 73 73 73 73 73 73 73 73 73 73 73 73 73 73 73 73 73 73 73 73 73 73 73 73 73 73 73 73 73 73 73 73 73 73 73 73 73 73 73 73 73 73 73 73 73 73 73 73 73 73 73 73 73 73 73 73 73 73 73 73 73 73 73 73 73 73 73 73
73 73 73 73 73 73 73 73 73 73 73 73 73 73 73 73 73 73 73 73 73 73 73 73 73 73 73 73 73 73 73 73 73 73 73 73 73 73 73 73 73 73 73 73 73 73 73 73 73 73 73 73 73 73 73 73 73 73 73 73 73 73 73 73 73 73 73 73 73 73 73 73
73 73 73 73 73 73 73 73 73 73 73 73 73 73 73 73 73 73 73 73 73 73 73 73 73 73 73 73 73 73 73 73 73 73 73 73 73 73 73 73 73 73 73 73 73 73 73 73 73 73 73 73 73 73 73 73 73 73 73 73 73 73 73 73 73 73 73 73 73 73 73 73
73 73 73 73 73 73 73 73 73 73 73 73 73 73 73 73 73 73 73 73 73 73 73 73 73 73 73 73 73 73 73 73 73 73 73 73 73 73 73 73 73 73 73 73 73 73 73 73 73 73 73 73 73 73 73 73 73 73 73 73 73 73 73 73 73 73 73 73 73 73 73 73
73 73 73 73 73 73 73 73 73 73 73 73 73 73 73 73 73 73 73 73 73 73 73 73 73 73 73 73 73 73 73 73 73 73 73 73 73 73 73 73 73 73 73 73 73 73 73 73 73 73 73 73 73 73 73 73 73 73 73 73 73 73 73 73 73 73 73 73 73 73 73 73
73 73 73 73 73 73 73 73 73 73 73 73 73 73 73 73 73 73 73 73 73 73 73 73 73 73 73 73 73 73 73 73 73 73 73 73 73 73 73 73 73 73 73 73 73 73 73 73 73 73 73 73 73 73 73 73 73 73 73 73 73 73 73 73 73 73 73 73 73 73 73 73
73 73 73 73 73 73 73 73 73 73 73 73 73 73 73 73 73 73 73 73 73 73 73 73 73 73 73 73 73 73 73 73 73 73 73 73 73 73 73 73 73 73 73 73 73 73 73 73 73 73 73 73 73 73 73 73 73 73 73 73 73 73 73 73 73 73 73 73 73 73 73 73
73 73 73 73 73 73 73 73 73 73 73 73 73 73 73 73 73 73 73 73 73 73 73 73 73 73 73 73 73 73 73 73 73 73 73 73 73 73 73 73 73 73 73 73 73 73 73 73 73 73 73 73 73 73 73 73 73 73 73 73 73 73 73 73 73 73 73 73 73 73 73 73
73 73 73 73 73 73 73 73 73 73 73 73 73 73 73 73 73 73 73 73 73 73 73 73 73 73 73 73 73 73 73 73 73 73 73 73 73 73 73 73 73 73 73 73 73 73 73 73 73 73 73 73 73 73 73 73 73 73 73 73 73 73 73 73 73 73 73 73 73 73 73 73
73 73 73 73 73 73 73 73 73 73 47 47 47 47 47 76 75 76 77 75 76 77 75 50 51 48 46 47 48 73 73 48 49 43 43 43 43 43 45 55 75 47 48 76 76 75 76 77 50 51 73 75 76 77 75 76 73 73 73 73 73 73 73 73 73 73 73 73 73 73 73 73
73 73 73 73 73 73 73 73 73 73 73 73 73 73 73 73 46 47 48 46 47 48 46 56 57 75 76 77 75 73 73 47 55 49 43 43 43 45 75 47 52 48 46 55 75 46 47 48 56 57 73 46 47 48 46 47 73 73 73 73 73 73 73 73 73 73 73 73 73 73 73 73
73 73 73 73 73 73 73 73 73 73 75 76 73 73 73 73 75 76 77 73 73 73 73 73 73 46 47 48 46 73 73 46 52 75 49 43 45 55 52 48 77 46 76 47 48 75 76 77 73 73 73 73 73 73 75 76 73 73 73 73 73 73 73 73 73 73 73 73 73 73 73 73
73 73 73 73 73 73 73 73 73 73 47 75 73 73 73 73 76 77 75 73 73 73 73 73 73 75 76 77 75 73 73 76 48 47 55 72 47 48 75 47 55 55 75 55 76 46 47 48 73 73 73 73 73 73 46 47 73 73 73 73 73 73 73 73 73 73 73 73 73 73 73 73
73 73 73 73 73 73 73 73 73 73 47 46 73 73 73 46 47 48 46 47 73 73 73 73 73 46 47 48 46 73 73 46 55 76 52 74 48 46 47 47 46 48 55 76 77 75 76 77 73 73 73 73 73 73 75 76 73 73 73 73 73 73 73 73 73 73 73 73 73 73 73 73
73 73 73 73 73 73 73 73 73 73 47 75 73 73 73 75 76 77 75 76 73 73 73 73 73 75 76 77 75 73 73 55 48 77 48 43 77 46 48 55 46 75 46 47 48 46 75 76 73 73 73 73 73 48 46 47 48 73 73 73 73 73 73 73 73 73 73 73 73 73 73 73
73 73 73 73 73 73 73 73 73 73 47 46 73 73 73 46 47 48 46 47 73 73 73 73 73 46 47 48 73 73 73 73 76 55 48 46 55 76 75 76 55 47 75 76 77 75 46 47 73 73 73 73 76 77 75 76 77 75 73 73 73 73 73 73 73 73 73 73 73 73 73 73
73 73 73 73 73 73 73 73 73 73 47 75 73 73 73 73 76 77 75 73 73 73 73 73 73 75 76 73 73 73 73 73 73 55 77 76 48 55 46 47 55 46 46 47 48 46 75 76 73 73 73 73 47 48 46 47 48 46 73 73 73 73 73 73 73 73 73 73 73 73 73 73
73 73 73 73 73 73 73 73 73 73 47 46 75 76 77 75 76 77 75 76 77 75 73 73 73 46 47 73 73 73 73 73 73 77 55 77 73 76 77 75 76 77 75 76 77 75 76 77 73 73 73 75 76 77 75 76 77 75 76 73 73 73 73 73 73 73 73 73 73 73 73 73
73 73 73 73 73 73 73 73 73 75 47 75 46 47 48 46 47 48 46 47 48 46 73 73 73 75 76 73 73 73 73 73 73 55 47 73 73 73 48 46 47 48 46 47 48 46 47 48 73 73 73 46 47 48 46 47 48 46 47 73 73 73 73 73 73 73 73 73 73 73 73 73
73 73 73 73 73 73 73 73 73 46 47 46 75 76 77 75 76 77 75 76 77 75 73 73 73 46 47 48 73 73 73 73 75 75 76 73 73 73 77 75 76 77 73 73 73 73 75 76 73 73 73 75 76 77 75 76 77 75 76 73 73 73 73 73 73 73 73 73 73 73 73 73
73 73 73 73 73 73 73 73 73 75 47 73 73 47 48 73 73 73 73 73 73 73 73 73 73 75 76 77 75 73 73 76 75 76 47 48 73 47 48 46 47 73 73 73 73 73 73 47 73 73 73 46 47 48 46 47 48 46 47 73 73 73 73 73 73 73 73 73 73 73 73 73
73 73 73 73 73 73 73 73 73 46 47 73 73 76 77 73 73 73 73 73 73 73 73 73 73 46 47 48 46 47 46 47 46 47 75 76 75 76 77 75 76 73 73 73 73 73 73 76 73 73 73 75 76 77 75 76 77 75 76 73 73 73 73 73 73 73 73 73 73 73 73 73
73 73 73 73 73 73 73 73 73 75 47 75 46 47 48 73 73 73 73 73 73 73 73 73 73 75 76 77 75 76 75 76 75 76 77 75 76 77 75 76 77 75 73 73 73 73 76 77 73 73 73 73 47 48 46 47 48 46 73 73 73 73 73 73 73 73 73 73 73 73 73 73
73 73 73 73 73 73 73 73 73 46 47 46 75 76 77 75 76 77 75 76 77 75 73 73 73 46 47 48 46 47 46 47 46 47 48 46 47 48 46 47 48 46 46 73 73 46 47 48 73 73 73 73 76 77 75 76 77 75 73 73 73 73 73 73 73 73 73 73 73 73 73 73
73 73 73 73 73 73 73 73 73 73 47 75 46 47 48 46 47 48 46 47 48 46 73 73 73 73 73 73 73 73 73 73 73 73 73 73 73 73 73 73 73 73 73 73 73 73 73 73 73 73 73 73 73 48 46 47 48 73 73 73 73 73 73 73 73 73 73 73 73 73 73 73
73 73 73 73 73 73 73 73 73 73 47 46 75 76 77 75 76 77 75 76 77 75 73 73 73 73 73 73 73 73 73 73 73 73 73 73 73 73 73 73 73 73 73 73 73 73 73 73 73 73 73 73 73 73 75 76 73 73 73 73 73 73 73 73 73 73 73 73 73 73 73 73
73 73 73 73 73 73 73 73 73 73 47 75 73 73 73 73 73 73 73 75 76 77 73 73 73 73 73 73 73 73 73 73 73 73 73 73 73 73 73 73 73 73 73 73 73 73 73 73 73 73 73 73 73 75 76 76 75 76 73 73 73 73 73 73 73 73 73 73 73 73 73 73
73 73 73 73 73 73 73 73 73 73 47 46 73 73 73 73 73 73 73 46 47 48 73 73 73 73 73 73 73 73 73 73 73 73 73 73 73 73 73 73 73 73 73 73 73 73 73 73 73 73 73 75 76 46 47 47 46 47 73 73 73 73 73 73 73 73 73 73 73 73 73 73
73 73 73 73 73 73 73 73 73 73 47 75 73 73 73 73 73 73 73 75 76 77 73 73 73 73 73 73 73 73 73 73 73 73 73 73 73 73 73 73 73 73 73 73 76 77 73 73 73 73 73 46 47 75 76 73 75 76 73 73 73 73 73 73 73 73 73 73 73 73 73 73
73 73 73 73 73 73 73 73 73 73 47 46 73 73 73 73 73 73 73 46 47 48 73 73 73 73 73 73 73 73 73 75 76 75 76 77 73 73 73 73 73 73 73 46 47 48 46 73 73 73 73 75 76 73 73 73 46 47 73 73 73 73 73 73 73 73 73 73 73 73 73 73
73 73 73 73 73 73 73 73 73 73 47 75 73 73 73 73 73 73 73 75 76 77 75 76 75 76 77 75 76 77 75 76 77 75 76 77 75 76 75 73 73 73 73 75 76 77 75 73 73 73 73 46 47 73 73 73 75 76 73 73 73 73 73 73 73 73 73 73 73 73 73 73
73 73 73 73 73 73 73 73 73 73 47 46 73 73 73 73 73 73 73 46 47 48 46 47 46 47 48 46 47 48 46 47 73 73 73 73 73 73 47 76 73 73 73 73 46 47 48 46 73 73 73 73 75 76 73 73 73 46 47 73 73 73 73 73 73 73 73 73 73 73 73 73 73
73 73 73 73 73 73 73 73 73 73 73 73 73 73 73 73 73 73 73 75 76 77 75 76 75 76 77 75 76 77 75 76 73 52 53 54 55 73 47 73 73 73 73 73 76 77 73 73 73 73 73 46 47 73 73 73 75 76 73 73 73 73 73 73 73 73 73 73 73 73 73 73
73 73 73 73 73 73 73 73 73 73 73 73 73 73 73 73 73 73 73 73 73 73 73 73 73 73 73 73 73 73 46 47 73 59 60 61 62 73 76 73 73 73 73 73 46 47 73 73 73 73 73 50 44 51 73 73 46 47 73 73 73 73 73 73 73 73 73 73 73 73 73 73
73 73 73 73 73 73 73 73 73 73 73 73 73 73 73 73 73 73 73 73 73 73 73 73 73 73 73 73 73 73 75 76 73 63 64 65 66 73 47 73 73 73 73 73 75 76 73 73 73 73 73 58 58 58 73 73 75 76 73 73 73 73 73 73 73 73 73 73 73 73 73 73
73 73 73 73 73 73 73 73 73 73 73 73 73 73 73 73 73 73 73 73 73 73 73 73 73 73 73 73 73 73 48 46 73 67 68 69 70 73 76 73 73 73 73 73 46 47 73 73 73 73 73 56 71 57 73 73 75 76 73 73 73 73 73 73 73 73 73 73 73 73 73 73
73 73 73 73 73 73 73 73 73 73 73 73 73 73 73 73 73 73 73 73 73 73 73 73 73 73 73 73 73 73 47 73 73 73 73 73 73 73 77 73 73 73 73 73 75 76 73 73 73 73 73 73 75 76 73 73 46 47 73 73 73 73 73 73 73 73 73 73 73 73 73 73
73 73 73 73 73 73 73 73 73 73 73 73 73 73 73 73 73 73 73 73 73 73 73 73 73 73 73 73 73 73 76 73 58 73 76 48 46 47 48 73 73 73 73 73 46 47 73 73 73 73 73 73 46 47 73 73 75 76 73 73 73 73 73 73 73 73 73 73 73 73 73 73
73 73 73 73 73 73 73 73 73 73 73 73 73 73 73 73 73 73 73 73 73 75 76 77 75 76 77 73 73 73 46 73 73 73 48 46 75 76 77 75 76 77 75 76 75 76 76 77 75 76 77 75 76 76 73 73 46 47 73 73 73 73 73 73 73 73 73 73 73 73 73 73
73 73 73 73 73 73 73 73 73 73 73 73 73 73 73 73 73 73 73 47 48 46 47 48 46 47 48 46 47 73 48 47 73 75 46 76 46 47 48 46 47 48 46 47 48 46 47 48 46 47 48 46 47 47 73 73 75 76 73 73 73 73 73 73 73 73 73 73 73 73 73 73
73 73 73 73 73 73 73 73 73 73 73 73 73 73 73 73 73 73 75 76 77 75 76 77 75 76 77 75 76 73 73 73 73 73 73 73 73 73 73 73 73 73 73 73 73 73 73 73 73 73 73 73 73 73 73 73 75 76 73 73 73 73 73 73 73 73 73 73 73 73 73 73
73 73 73 73 73 73 73 73 73 73 73 73 73 73 73 73 73 73 73 47 48 46 47 48 46 47 48 46 47 73 73 73 73 73 73 73 73 73 73 73 73 73 73 73 73 73 73 73 73 73 73 73 73 73 73 73 46 47 73 73 73 73 73 73 73 73 73 73 73 73 73 73
73 73 73 73 73 73 73 73 73 73 73 73 73 73 73 73 73 73 73 73 73 75 76 77 75 76 77 73 73 73 73 73 73 73 73 73 73 73 73 73 73 73 73 73 73 73 73 73 73 73 73 73 73 73 73 73 75 76 73 73 73 73 73 73 73 73 73 73 73 73 73 73
73 73 73 73 73 73 73 73 73 73 73 73 73 73 73 73 73 73 73 73 73 73 73 73 73 73 73 73 75 76 75 75 76 77 75 76 77 75 76 77 75 76 77 75 76 77 75 75 75 76 77 75 76 77 75 76 77 75 73 73 73 73 73 73 73 73 73 73 73 73 73 73
73 73 73 73 73 73 73 73 73 73 73 73 73 73 73 73 73 73 73 73 73 73 73 73 75 76 75 75 75 76 46 46 47 48 46 47 48 46 47 48 46 47 48 46 47 48 46 46 46 47 48 46 47 48 46 47 48 46 73 73 73 73 73 73 73 73 73 73 73 73 73 73
73 73 73 73 73 73 73 73 73 73 73 73 73 73 73 73 73 73 73 73 73 73 73 73 75 76 46 46 46 47 73 73 73 73 73 73 73 73 73 73 73 73 73 73 73 73 73 73 73 73 73 73 73 73 73 73 73 73 73 73 73 73 73 73 73 73 73 73 73 73 73 73
73 73 73 73 73 73 73 73 73 73 73 73 73 73 77 75 76 77 75 73 73 73 73 73 46 47 73 73 73 73 73 73 75 76 73 73 73 73 73 73 73 73 73 73 73 73 73 73 73 73 73 73 73 75 76 77 73 73 73 73 73 73 73 73 73 73 73 73 73 73 73 73
73 73 73 73 73 73 73 73 73 73 73 73 73 47 48 46 47 48 46 47 73 73 73 73 75 76 73 73 73 73 73 73 46 47 73 73 73 73 73 73 73 73 73 73 73 73 73 73 73 73 73 77 75 76 77 75 76 77 73 73 73 73 73 73 73 73 73 73 73 73 73 73
73 73 73 73 73 73 73 73 73 73 73 73 75 76 77 75 76 77 75 76 77 75 76 77 75 76 73 73 73 73 73 73 75 76 73 73 73 73 73 73 73 73 73 73 73 73 73 73 73 73 47 48 46 47 48 46 47 48 46 73 73 73 73 73 73 73 73 73 73 73 73 73
73 73 73 73 73 73 73 73 73 73 73 73 46 47 48 46 47 48 46 47 48 46 47 48 46 47 73 73 73 73 73 73 46 47 73 73 73 73 73 73 73 73 73 73 73 73 73 73 73 75 76 77 75 76 77 75 76 77 75 76 73 73 73 73 73 73 73 73 73 73 73 73
73 73 73 73 73 73 73 73 73 73 73 73 73 76 77 75 76 77 75 76 73 73 73 73 73 73 73 73 73 73 73 73 75 76 73 73 73 73 73 73 73 73 73 73 73 73 73 73 73 73 47 48 46 47 48 46 47 48 46 73 73 73 73 73 73 73 73 73 73 73 73 73
73 73 73 73 73 73 73 73 73 73 73 73 73 73 48 46 47 48 46 73 73 73 73 73 73 73 73 73 73 73 73 76 46 47 76 73 73 73 73 73 73 73 73 73 73 73 73 73 73 73 73 77 75 76 77 75 76 77 73 73 73 73 73 73 73 73 73 73 73 73 73 73
73 73 73 73 73 73 73 73 73 73 75 76 77 75 76 77 75 76 77 75 76 77 75 76 77 75 76 77 75 76 46 47 48 46 47 76 77 75 76 76 77 75 76 75 76 77 75 76 77 75 76 77 75 76 77 75 76 77 75 76 73 73 73 73 73 73 73 73 73 73 73 73
73 73 73 73 73 73 73 73 73 73 46 47 48 46 47 48 46 47 48 46 47 48 46 47 48 46 47 48 46 47 48 76 77 75 46 47 48 46 47 48 46 47 48 46 47 48 46 47 48 46 47 48 46 47 48 46 47 48 46 47 73 73 73 73 73 73 73 73 73 73 73 73
73 73 73 73 73 73 73 73 73 73 75 76 77 75 76 77 75 76 77 75 76 77 75 76 77 75 76 77 75 76 77 75 76 77 75 76 77 75 76 77 75 76 77 75 76 77 75 76 77 75 76 77 75 76 77 75 76 77 75 76 73 73 73 73 73 73 73 73 73 73 73 73
73 73 73 73 73 73 73 73 73 73 46 47 48 46 47 48 46 47 48 46 47 48 46 47 48 46 47 48 46 47 48 46 47 48 46 47 48 46 47 48 46 47 48 46 47 48 46 47 48 46 47 48 46 47 48 46 47 48 46 47 73 73 73 73 73 73 73 73 73 73 73 73
73 73 73 73 73 73 73 73 73 73 75 76 77 75 76 77 75 76 77 75 76 77 75 76 77 75 76 77 75 76 77 75 76 77 75 76 77 75 76 77 75 76 77 75 76 77 75 76 77 75 76 77 75 76 77 75 76 77 75 76 73 73 73 73 73 73 73 73 73 73 73 73
73 73 73 73 73 73 73 73 73 73 46 47 48 46 47 48 46 47 48 46 47 48 46 47 48 46 47 48 46 47 48 46 47 48 46 47 48 46 47 48 46 47 48 46 47 48 46 47 48 46 47 48 46 47 48 46 47 48 46 47 73 73 73 73 73 73 73 73 73 73 73 73
73 73 73 73 73 73 73 73 73 73 75 76 77 75 76 77 75 76 77 75 76 77 75 76 77 75 76 77 75 76 77 75 76 77 75 76 77 75 76 77 75 76 77 75 76 77 75 76 77 75 75 76 77 75 76 77 75 76 77 75 73 73 73 73 73 73 73 73 73 73 73 73
73 73 73 73 73 73 73 73 73 73 73 73 73 73 73 73 73 73 73 73 73 73 73 73 73 73 73 73 73 73 73 73 73 73 73 73 73 73 73 73 73 73 73 73 73 73 73 73 73 73 73 73 73 73 73 73 73 73 73 73 73 73 73 73 73 73 73 73 73 73 73 73
73 73 73 73 73 73 73 73 73 73 73 73 73 73 73 73 73 73 73 73 73 73 73 73 73 73 73 73 73 73 73 73 73 73 73 73 73 73 73 73 73 73 73 73 73 73 73 73 73 73 73 73 73 73 73 73 73 73 73 73 73 73 73 73 73 73 73 73 73 73 73 73
73 73 73 73 73 73 73 73 73 73 73 73 73 73 73 73 73 73 73 73 73 73 73 73 73 73 73 73 73 73 73 73 73 73 73 73 73 73 73 73 73 73 73 73 73 73 73 73 73 73 73 73 73 73 73 73 73 73 73 73 73 73 73 73 73 73 73 73 73 73 73 73
73 73 73 73 73 73 73 73 73 73 73 73 73 73 73 73 73 73 73 73 73 73 73 73 73 73 73 73 73 73 73 73 73 73 73 73 73 73 73 73 73 73 73 73 73 73 73 73 73 73 73 73 73 73 73 73 73 73 73 73 73 73 73 73 73 73 73 73 73 73 73 73
73 73 73 73 73 73 73 73 73 73 73 73 73 73 73 73 73 73 73 73 73 73 73 73 73 73 73 73 73 73 73 73 73 73 73 73 73 73 73 73 73 73 73 73 73 73 73 73 73 73 73 73 73 73 73 73 73 73 73 73 73 73 73 73 73 73 73 73 73 73 73 73
73 73 73 73 73 73 73 73 73 73 73 73 73 73 73 73 73 73 73 73 73 73 73 73 73 73 73 73 73 73 73 73 73 73 73 73 73 73 73 73 73 73 73 73 73 73 73 73 73 73 73 73 73 73 73 73 73 73 73 73 73 73 73 73 73 73 73 73 73 73 73 73
73 73 73 73 73 73 73 73 73 73 73 73 73 73 73 73 73 73 73 73 73 73 73 73 73 73 73 73 73 73 73 73 73 73 73 73 73 73 73 73 73 73 73 73 73 73 73 73 73 73 73 73 73 73 73 73 73 73 73 73 73 73 73 73 73 73 73 73 73 73 73 73
73 73 73 73 73 73 73 73 73 73 73 73 73 73 73 73 73 73 73 73 73 73 73 73 73 73 73 73 73 73 73 73 73 73 73 73 73 73 73 73 73 73 73 73 73 73 73 73 73 73 73 73 73 73 73 73 73 73 73 73 73 73 73 73 73 73 73 73 73 73 73 73
73 73 73 73 73 73 73 73 73 73 73 73 73 73 73 73 73 73 73 73 73 73 73 73 73 73 73 73 73 73 73 73 73 73 73 73 73 73 73 73 73 73 73 73 73 73 73 73 73 73 73 73 73 73 73 73 73 73 73 73 73 73 73 73 73 73 73 73 73 73 73 73
73 73 73 73 73 73 73 73 73 73 73 73 73 73 73 73 73 73 73 73 73 73 73 73 73 73 73 73 73 73 73 73 73 73 73 73 73 73 73 73 73 73 73 73 73 73 73 73 73 73 73 73 73 73 73 73 73 73 73 73 73 73 73 73 73 73 73 73 73 73 73 73
73 73 73 73 73 73 73 73 73 73 73 73 73 73 73 73 73 73 73 73 73 73 73 73 73 73 73 73 73 73 73 73 73 73 73 73 73 73 73 73 73 73 73 73 73 73 73 73 73 73 73 73 73 73 73 73 73 73 73 73 73 73 73 73 73 73 73 73 73 73 73 73
73 73 73 73 73 73 73 73 73 73 73 73 73 73 73 73 73 73 73 73 73 73 73 73 73 73 73 73 73 73 73 73 73 73 73 73 73 73 73 73 73 73 73 73 73 73 73 73 73 73 73 73 73 73 73 73 73 73 73 73 73 73 73 73 73 73 73 73 73 73 73 73
