3 2 2 2 2 2 2 2 2 2 2 2 2 2 2 2 2 0 0 0 0 0 0 0 0 4 4 4 4 5 5 5 5 5 5 5 5 5 5 5 4 4 4 4 0 0 0 0 5 3
3 2 13 16 16 16 16 16 16 16 16 16 16 16 12 2 3 0 0 0 0 0 0 0 0 4 4 4 4 5 5 5 5 0 0 0 0 0 0 0 0 0 0 0 0 0 0 0 5 3
3 2 14 1 1 1 1 1 1 1 1 1 1 1 15 2 3 0 0 0 0 0 0 0 0 4 4 4 4 5 5 5 5 5 5 5 5 5 5 5 4 4 4 4 0 0 0 0 5 3 
3 2 14 1 1 1 1 1 1 1 1 1 1 1 15 2 3 0 0 0 0 0 0 0 0 4 4 5 5 5 5 5 5 5 5 5 5 5 5 5 5 5 4 4 0 0 0 0 5 3
3 2 10 18 1 1 1 1 1 1 1 1 1 20 11 2 3 0 0 0 0 0 0 0 0 4 4 5 5 5 5 5 5 5 5 5 5 5 5 5 5 5 4 4 0 0 0 0 5 3
3 3 2 10 18 1 1 1 1 1 1 1 20 11 2 2 3 0 0 0 0 0 0 0 0 4 4 5 5 5 5 5 5 5 5 5 5 5 5 5 5 5 4 4 0 0 0 0 5 3
3 3 2 2 14 1 1 1 1 1 1 1 15 2 2 3 3 0 0 0 0 0 0 0 0 4 4 4 4 5 5 5 5 5 5 5 5 5 5 5 4 4 4 4 0 0 0 0 5 3
3 3 3 2 10 18 1 1 1 1 1 20 11 2 3 3 3 0 0 0 0 0 0 0 0 4 4 4 4 5 5 5 5 5 5 5 5 5 5 5 4 4 4 4 0 0 0 0 5 3
3 3 3 2 2 10 17 18 1 20 17 11 2 2 3 3 3 0 0 0 0 0 0 0 0 4 4 4 4 4 5 5 5 5 5 5 5 5 5 4 4 4 4 4 0 0 0 0 5 3 
3 3 3 3 2 2 2 14 1 15 2 2 2 2 3 3 3 0 0 0 0 0 0 0 0 4 4 4 4 4 4 4 4 4 2 2 2 4 4 4 4 4 4 4 0 0 0 0 5 3 
0 0 0 0 0 0 0 2 2 2 2 0 0 0 0 0 0 0 0 0 0 0 0 0 0 4 4 4 4 4 4 4 4 4 2 2 2 4 4 4 4 4 4 4 0 0 0 0 5 3 
0 4 4 4 5 5 5 2 2 2 5 5 5 4 4 4 0 0 0 8 9 0 0 0 0 5 5 5 5 5 5 5 5 4 2 2 2 4 5 5 5 5 5 5 0 0 0 0 5 3 
0 4 4 4 5 5 5 2 2 2 5 5 5 4 4 4 0 0 0 6 7 0 0 0 0 5 5 5 5 5 5 5 5 4 2 2 2 4 5 5 5 5 5 5 0 0 0 0 5 3 
0 0 0 0 0 0 5 2 2 2 5 5 5 4 4 4 0 0 0 2 2 0 0 0 0 5 5 5 5 5 5 5 5 4 2 2 2 4 5 5 5 5 5 5 0 0 0 0 5 3 
0 4 4 4 5 0 5 2 2 2 5 5 5 4 4 4 0 0 0 2 2 0 0 0 0 5 5 5 5 5 5 5 5 4 2 2 2 4 5 5 5 5 5 5 0 0 0 0 5 3 
0 4 0 0 5 0 5 2 2 2 5 5 5 4 4 4 0 0 0 2 2 0 0 0 0 5 5 5 5 26 5 5 5 4 2 2 2 4 5 5 5 5 5 5 0 0 0 0 5 3 
0 4 0 4 5 0 5 2 2 2 2 2 2 2 2 2 2 2 2 2 2 2 2 0 0 5 5 5 5 27 5 5 5 4 2 2 2 4 5 5 5 5 5 5 0 0 0 0 5 3
0 4 0 0 0 0 5 2 2 2 2 2 2 2 2 2 2 2 2 2 2 2 2 0 0 0 0 0 0 0 0 0 0 0 2 2 2 0 0 0 0 0 0 0 0 0 0 0 5 3 
0 4 4 4 5 5 5 2 2 2 2 2 2 2 2 2 2 2 2 2 2 2 2 2 2 2 2 2 2 2 2 2 2 2 2 2 2 4 5 5 5 5 5 5 0 0 0 0 5 3
4 4 4 4 5 5 5 5 5 5 5 5 5 5 5 5 5 5 5 5 2 2 2 2 2 2 2 2 2 2 2 2 2 2 2 2 2 4 5 5 5 5 5 5 0 0 0 0 5 3 
0 0 0 0 0 0 0 0 0 0 0 0 0 0 0 0 0 0 0 0 2 2 2 2 2 2 2 2 2 2 2 2 2 2 2 2 2 4 5 5 5 5 5 5 0 0 0 0 5 3
3 3 3 3 3 3 3 3 3 3 3 3 3 3 3 3 3 0 0 0 2 2 2 4 4 4 4 4 4 4 4 4 4 4 4 4 4 4 5 5 5 5 5 5 0 0 0 0 5 3 
16 16 16 16 16 16 16 16 16 16 16 16 16 16 16 12 3 0 0 0 2 2 2 4 4 4 4 4 4 4 4 5 5 5 5 5 5 5 5 5 5 5 5 5 0 0 0 0 5 3 
1 1 1 1 1 1 1 1 1 1 1 1 1 1 1 15 3 0 0 0 2 2 2 4 4 4 4 4 4 4 4 5 5 5 5 5 5 5 5 5 5 5 5 5 0 0 0 0 5 3 
1 1 1 1 1 1 1 1 1 1 1 1 1 1 20 11 3 0 0 0 2 2 2 4 4 4 4 4 4 4 4 5 5 5 5 5 5 5 5 5 5 5 5 5 0 0 0 0 5 3
1 1 1 1 1 1 1 1 1 1 1 1 1 20 11 3 3 5 5 5 2 2 2 4 4 4 4 4 4 4 4 4 4 4 4 4 4 4 4 4 4 4 4 4 0 0 0 0 5 3 
1 1 1 1 1 1 1 1 1 1 1 1 1 15 3 3 3 5 5 5 2 2 2 4 4 4 4 4 4 4 4 4 4 4 4 4 4 4 4 4 4 4 4 4 0 0 0 0 5 3 
1 1 1 1 1 1 1 1 1 1 1 1 1 15 2 2 2 2 2 2 2 2 2 2 2 2 2 2 2 2 2 2 2 2 2 2 2 2 2 2 2 2 2 2 0 0 0 0 5 3
1 1 1 1 1 1 1 1 1 1 1 1 1 15 2 2 2 2 2 2 2 2 2 2 2 2 2 2 2 2 2 2 2 2 2 2 2 2 2 2 2 2 2 2 0 0 0 0 5 3
1 1 1 1 1 1 1 1 1 1 1 1 1 15 2 2 2 2 2 2 2 2 2 2 2 2 2 2 2 2 2 2 2 2 2 2 2 2 2 2 2 2 2 2 0 0 0 0 5 3
1 1 1 1 1 1 1 1 1 1 1 1 1 15 3 3 3 5 5 5 2 2 2 4 4 4 4 4 4 4 4 4 4 4 4 4 4 4 4 4 4 4 4 4 0 0 0 0 5 3
1 1 1 1 1 1 1 1 1 1 1 1 1 21 12 3 3 5 5 5 2 2 2 4 4 4 4 5 5 5 5 5 5 5 5 5 5 5 5 5 5 5 5 5 0 0 0 0 5 3
1 1 1 1 1 1 1 1 1 1 1 1 1 1 21 12 3 0 0 0 2 2 2 4 4 4 4 5 5 5 5 5 5 5 5 5 5 5 5 5 5 5 5 5 0 0 0 0 5 3
1 1 1 1 1 1 1 1 1 1 1 1 1 1 1 15 3 0 0 0 2 2 2 4 4 4 4 5 5 5 5 5 5 5 5 5 5 5 5 5 5 5 5 5 0 0 0 0 5 3
1 1 1 1 1 1 1 1 1 1 1 1 1 1 1 15 3 0 0 0 2 2 2 4 4 4 4 4 4 4 4 4 4 4 4 4 4 4 4 4 5 5 5 5 0 0 0 0 5 3
17 17 17 17 17 17 17 18 1 1 20 17 17 17 17 11 3 0 0 0 2 2 2 2 2 2 2 2 2 2 2 2 2 2 2 2 2 2 2 4 5 5 5 5 0 0 0 0 5 3
3 3 3 3 3 3 3 14 1 1 15 3 3 3 3 3 3 0 0 0 2 2 2 2 2 2 2 2 2 2 2 2 2 2 2 2 2 2 2 4 5 5 5 5 0 0 0 0 5 3
0 0 0 0 0 0 3 14 1 1 15 3 0 0 0 0 0 0 0 0 2 2 2 2 2 2 2 2 2 2 2 2 2 2 2 2 2 2 2 4 5 5 5 5 0 0 0 0 5 3
0 0 0 0 0 0 3 3 22 23 3 3 0 0 0 0 0 0 0 0 0 0 0 0 0 0 0 0 0 0 0 0 0 0 0 0 2 2 2 4 5 5 5 5 0 0 0 0 5 3
0 0 0 0 0 0 3 3 24 25 3 3 0 0 0 0 0 0 0 0 0 0 0 0 4 4 4 5 5 5 5 5 4 4 4 0 2 2 2 4 5 5 5 5 0 0 0 0 5 3 
0 0 0 0 0 0 3 14 1 1 15 3 0 0 0 0 0 0 0 0 0 0 0 0 4 4 4 5 5 5 5 5 4 4 4 0 2 2 2 0 0 0 0 0 0 0 0 0 5 3
3 3 3 3 3 3 3 14 1 1 15 3 3 3 3 3 3 3 3 3 3 3 3 0 4 4 4 5 5 5 5 5 4 4 4 0 2 2 2 0 0 0 0 0 0 0 0 0 5 3
16 16 16 16 16 16 16 19 1 1 21 16 16 16 16 16 16 16 16 16 16 12 3 0 4 4 4 5 5 5 5 5 4 4 4 0 2 2 2 0 0 0 0 0 0 0 0 0 5 3
1 1 1 1 1 1 1 1 1 1 1 1 1 1 1 1 1 1 1 1 1 15 3 0 4 4 4 5 5 5 5 5 4 4 4 0 2 2 2 4 5 5 5 5 0 0 0 0 5 3
1 1 1 1 1 1 1 1 1 1 1 1 1 1 1 1 1 1 1 1 1 15 3 0 4 4 4 5 5 5 5 5 4 4 4 0 2 2 2 4 5 5 5 5 0 0 0 0 5 3
1 1 1 1 1 1 1 1 1 1 1 1 1 1 1 1 1 1 1 1 1 15 3 0 0 0 0 0 0 0 0 0 0 0 0 0 2 2 2 4 5 5 5 5 0 0 0 0 5 3
1 1 1 1 1 1 1 1 1 1 1 1 1 1 1 1 1 1 1 1 1 15 2 2 2 2 2 2 2 2 2 2 2 2 2 2 2 2 2 4 5 5 5 5 0 0 0 0 5 3
1 1 1 1 1 1 1 1 1 1 1 1 1 1 1 1 1 1 1 1 1 15 2 2 2 2 2 2 2 2 2 2 2 2 2 2 2 2 2 4 5 5 5 5 0 0 0 0 5 3
17 17 17 17 17 17 17 17 17 17 17 17 17 17 17 17 17 17 17 17 17 11 2 2 2 2 2 2 2 2 2 2 2 2 2 2 2 2 2 4 5 5 5 5 0 0 0 0 5 3
3 3 3 3 3 3 3 3 3 3 3 3 3 3 3 3 3 3 3 3 3 3 3 0 0 0 0 0 0 0 0 0 0 0 0 0 0 0 0 0 0 0 0 0 0 0 0 0 0 0




















